  11111
  1AAAF
111AAA111
1AAAAAA*1
1GAAAAAA1
1AAGAAAA1
1AAAGAAA1
1AAAAAAA1
1AAAIAAA1
111111111