55555555555555555555555555555555555555555555555555
5EEEEEEE5E555E111111E5555--55EEE5EEE55-----5EEEE55
5E555E5E5EEEEE1AKAA1EEEEE55EEE5EE55EEE5555-5E55EEF
5EEE5E5E55E55ENAAMATE555EEEE5EE5EE5E5EEEEE55EEE5E5
555E5EEEE5EEEE1AAAA1EE5-5E5EE5EE5EE5EE555EEEE5EEE5
5E5E5EE5EE5E551AAAA15E555E55EE5EE55EE5EEE5E5E55E55
5EEE5EEE5E5EEE111111EEEE5EEE5EE555EE55E5EEE5EEEE55
5E55E5E55E5E5EEEEE5EE55EEE5EE5EEE5E5E5EE555-555E55
5EE5E5EEEE5E5E5E555E5EEE5EE5EEE5EEE5EE5EEEE5EEEEE5
55E5EEE5EEEEEE5EEEEEE55555EE551111N11E5555EE5E55E5
55E11T111E55E1111111E5EEEE5EEETAAAAA1EEEE55E5EE5E5
55E1AAAA1EE5E1OAAAA1EEE55E55E51AAAAA1E5E5EEE55EEE5
55E1AAAA15EEE1AAAAA155EE5E5EE51APAAA1EEEEE22222225
5EE1AAAA15E5E1AAAAA1EEE5EEEE5-1AAAAA15E5E52BBBBB25
5E51AAAA1EEEE1AAAAA15E5EE5E5--1AAAAA15E5E52BBBBB25
5E51AAAATE5E51AAAAA15EEE55EE551111111EE5E52BBBBB25
5EE111111EEE5111N111EE55E55EEEEE5---5E5EE52BBBBB25
55EEE5EEE5E55E5EEEE5E5-5EEEE555EE555EE5E5-2BBBBB25
5E55EEE5EEEEEE5E5E5EEE5EE5555EE5EEEEE55EE52T222T25
5EEE53333T3E5EEE5EE55EEE55EEEE5EE55E5E55EEEEEEEE55
5E5E53CCCC3EE55E55EE555EEEE55EE55-5E5EEEE5E5555E55
5E5E53CCCC35E55E5E5EEEE555EEE5E5-5EE55E5E5E5EEEEE5
5EEE53CCCCNEEEEEEE5555EE55555EEE5EE5EEE5EEE55E55E5
55E5-3CCCC3E5E555EEEEE5EEE55EE5E5E5EE1111111EE55E5
5EE5-333333E5EEEE5555E555EEEE5EEEE5E51AAAAA1E5-5E5
5E5-----5EEEEE55EEEEEEEEEE5E55E555EE51AAAAA1E55EE5
5EE555555E22T222E55555E55E5EEEE5EEE5-1AAAAA1E5EE55
55EEEEEEEE2BBBB2EEEEEEE5EEEEE55EE5E5-1AAAZA1E5E5-5
5EE55555552BBBB2555E555EE555E55E5EEE51AAAAA1E5E5-5
5E5EE5EEEE2BBBB2EEEE5EEE5EEEEE5EEE5EE1T1T111E5E5-5
5EE5EEE55E2BBBBTE51111111E5E5EE5E5-55EEEEEEEE5E5-5
55E5E55EEE2BBBB2E51AAAAA1E5EE5E5EE55EE55555E5EEE55
5EEE55EE5E222222EE1AAAAATE55E5E55EE5E5EEEEEE5E5EE5
5E5EEEE55E5EEE555E1LAAAA1EEE5EEE55EEEE55E5555EE5E5
5111111E5E5E5EEEEE1AAAAA1E5EEE5EEEEE55EEE5EEE5EE55
51AAAA1E5E55EE5E5E1AAAAA15EE55-555EEEEE5EEE5EE5EE5
51AAAA1EEEE5E55EE511111115E522222255E5EEE55E5EE5E5
51AAAA1E55EE5--5EE555EEEE5E52BBBB2EEE5E55EEE55EEE5
51AAAATE5E5EE5-55EEEEE5E5EEE2BBPB2E55EEEEE5EE55555
51AAAA1E5E55E55EEE55555E555E2BBBB2E5EEE5E555E5EEE5
5111111E5EEEEEEE5EE5EE5EEEEE2BBBB2E5E5EEEEE55EE5E5
5----5EEE555555EE5EEE5EE5E552BBBB2EEE5E555EEEE55E5
5---5EE5EE5333333E55E5E55E5E2T2222E55EEEEEEE55EEE5
5--5EE5-5E53CCCC3EEEE55EEE5EEEE5EEEEEE5E55E5E5E555
555EE5E5EEE3CCCCNE555EEE55EE55EEE55E55EE55EEEEEEE5
5EEE5EE5E5ETCCCC3EEEEE5E5EE5E5555555EEE5E5E5E55E55
5E5EEE55E5E3CCCC35555EEE5E55EEEEEEEEE5EEE5E5E55EE5
5EE5555EEE53CCCC3---5E5EEEEEE55555E5E5555EEE5EEEE5
55IEEEEE5EE333333---5EEE5555EEEEEEE5EEEEEE5EEE5EE5
55555555555555555555555555555555555555555555555555
